pelvis_tilt	pelvis_tilt
pelvis_list	pelvis_list
pelvis_rotation	pelvis_rotation
pelvis_tx	pelvis_tx
pelvis_ty	pelvis_ty
pelvis_tz	pelvis_tz
hip_flexion_r	hip_flexion_r
hip_adduction_r	hip_adduction_r
hip_rotation_r	hip_rotation_r
knee_angle_r	knee_angle_r
ankle_angle_r	ankle_angle_r
subtalar_angle_r	subtalar_angle_r
mtp_angle_r	mtp_angle_r
hip_flexion_l	hip_flexion_l
hip_adduction_l	hip_adduction_l
hip_rotation_l	hip_rotation_l
knee_angle_l	knee_angle_l
ankle_angle_l	ankle_angle_l
subtalar_angle_l	subtalar_angle_l
mtp_angle_l	mtp_angle_l
lumbar_extension	lumbar_extension
lumbar_bending	lumbar_bending
lumbar_rotation	lumbar_rotation
glut_med1_r	glut_med1_r
glut_med2_r	glut_med2_r
glut_med3_r	glut_med3_r
glut_min1_r	glut_min1_r
glut_min2_r	glut_min2_r
glut_min3_r	glut_min3_r
semimem_r	semimem_r
semiten_r	semiten_r
bifemlh_r	bifemlh_r
bifemsh_r	bifemsh_r
sar_r	sar_r
add_long_r	add_long_r
add_brev_r	add_brev_r
add_mag1_r	add_mag1_r
add_mag2_r	add_mag2_r
add_mag3_r	add_mag3_r
tfl_r	tfl_r
pect_r	pect_r
grac_r	grac_r
glut_max1_r	glut_max1_r
glut_max2_r	glut_max2_r
glut_max3_r	glut_max3_r
iliacus_r	iliacus_r
psoas_r	psoas_r
quad_fem_r	quad_fem_r
gem_r	gem_r
peri_r	peri_r
rect_fem_r	rect_fem_r
vas_med_r	vas_med_r
vas_int_r	vas_int_r
vas_lat_r	vas_lat_r
med_gas_r	med_gas_r
lat_gas_r	lat_gas_r
soleus_r	soleus_r
tib_post_r	tib_post_r
flex_dig_r	flex_dig_r
flex_hal_r	flex_hal_r
tib_ant_r	tib_ant_r
per_brev_r	per_brev_r
per_long_r	per_long_r
per_tert_r	per_tert_r
ext_dig_r	ext_dig_r
ext_hal_r	ext_hal_r
glut_med1_l	glut_med1_l
glut_med2_l	glut_med2_l
glut_med3_l	glut_med3_l
glut_min1_l	glut_min1_l
glut_min2_l	glut_min2_l
glut_min3_l	glut_min3_l
semimem_l	semimem_l
semiten_l	semiten_l
bifemlh_l	bifemlh_l
bifemsh_l	bifemsh_l
sar_l	sar_l
add_long_l	add_long_l
add_brev_l	add_brev_l
add_mag1_l	add_mag1_l
add_mag2_l	add_mag2_l
add_mag3_l	add_mag3_l
tfl_l	tfl_l
pect_l	pect_l
grac_l	grac_l
glut_max1_l	glut_max1_l
glut_max2_l	glut_max2_l
glut_max3_l	glut_max3_l
iliacus_l	iliacus_l
psoas_l	psoas_l
quad_fem_l	quad_fem_l
gem_l	gem_l
peri_l	peri_l
rect_fem_l	rect_fem_l
vas_med_l	vas_med_l
vas_int_l	vas_int_l
vas_lat_l	vas_lat_l
med_gas_l	med_gas_l
lat_gas_l	lat_gas_l
soleus_l	soleus_l
tib_post_l	tib_post_l
flex_dig_l	flex_dig_l
flex_hal_l	flex_hal_l
tib_ant_l	tib_ant_l
per_brev_l	per_brev_l
per_long_l	per_long_l
per_tert_l	per_tert_l
ext_dig_l	ext_dig_l
ext_hal_l	ext_hal_l
ercspn_r	ercspn_r
ercspn_l	ercspn_l
intobl_r	intobl_r
intobl_l	intobl_l
extobl_r	extobl_r
extobl_l	extobl_l
